11111111111111111111111111111111111111111111111111
11111111111111111111111111111111111111111111111111
11111111111111111111111111111111111111111111111111
11111111111111111111111111111111111111111111111111
11111111111111111111111141004111111111111111111111
11111111111111111111114111111141111111111111111111
11111111111111111110011111111111411111111111111111
11114411111441100111111111111111114114411441144111
21111111111111111111111111111111111141111111111113
00000000000110000000000110011001100001100110011000

