0110002000000000000
0011111000000000000
0010001111111110000
0110001000000010000
0100001110011110000
0100000001110000000
0111000001000000000
0001000001111110000
0001111000000010000
0111000000000010000
0111111110000010000
0100010000000010000
0000010000000010000
0000011110000010000
0000000011100010000
0000000000010010000
0000011111110010000
0000000000000010000
0000000000000011113
